#######################################
# Syntax Coloring Map LCDdogmSPI
#######################################

#######################################
# Datatypes (KEYWORD1)
#######################################

LeptonSDKEmb32OEM KEYWORD1

LEP_UINT8	KEYWORD1
LEP_UCHAR	KEYWORD1
LEP_INT8	KEYWORD1
LEP_CHAR8	KEYWORD1

LEP_UINT16	KEYWORD1
LEP_USHORT	KEYWORD1
LEP_INT16	KEYWORD1
LEP_SHORT	KEYWORD1

LEP_UINT32	KEYWORD1
LEP_UINT	KEYWORD1
LEP_INT32	KEYWORD1
LEP_INT	KEYWORD1

LEP_UINT64	KEYWORD1
LEP_ULONG64	KEYWORD1
LEP_ULONG32	KEYWORD1
LEP_ULONG	KEYWORD1
LEP_LONG32	KEYWORD1
LEP_LONG	KEYWORD1

LEP_FLOAT32	KEYWORD1
LEP_FLOAT64	KEYWORD1

LEP_BOOL	KEYWORD1
LEP_BOOL_PTR	KEYWORD1

LEP_COMMAND_ID	KEYWORD1
LEP_ATTRIBUTE_T	KEYWORD1
LEP_ATTRIBUTE_T_PTR	KEYWORD1

LEP_BYTE_ORDER_T	KEYWORD1
LEP_BYTE_ORDER_T_PTR	KEYWORD1

LEP_OPERATION_STATE	KEYWORD1

LEP_ENABLE_STATE	KEYWORD1

LEP_ON_STATE	KEYWORD1

LEP_CAMERA_PORT_E	KEYWORD1
LEP_CAMERA_PORT_E_PTR	KEYWORD1

LEP_PROTOCOL_DEVICE_E	KEYWORD1
LEP_PROTOCOL_DEVICE_E_PTR	KEYWORD1

LEP_TWI_CLOCK_RATE_T	KEYWORD1
LEP_TWI_CLOCK_RATE_T_PTR	KEYWORD1

LEP_SPI_CLOCK_RATE_T	KEYWORD1
LEP_SPI_CLOCK_RATE_T_PTR	KEYWORD1

LEP_CAMERA_PORT_DESC_T	KEYWORD1
LEP_CAMERA_PORT_DESC_T_PTR	KEYWORD1

LEP_SDK_VERSION_T	KEYWORD1
LEP_SDK_VERSION_T_PTR	KEYWORD1

LEP_SDK_BOOT_STATUS_E	KEYWORD1
LEP_SDK_BOOT_STATUS_E_PTR	KEYWORD1
 
LEP_RESULT	KEYWORD1

LEP_AGC_HEQ_EMPTY_COUNT_T	KEYWORD1
LEP_AGC_HEQ_EMPTY_COUNT_T_PTR	KEYWORD1
LEP_AGC_HEQ_NORMALIZATION_FACTOR_T	KEYWORD1
LEP_AGC_HEQ_NORMALIZATION_FACTOR_T_PTR	KEYWORD1

LEP_AGC_ENABLE_E	KEYWORD1
LEP_AGC_ENABLE_E_PTR	KEYWORD1

LEP_AGC_POLICY_E	KEYWORD1
LEP_AGC_POLICY_E_PTR	KEYWORD1

LEP_AGC_ROI_T	KEYWORD1
LEP_AGC_ROI_T_PTR	KEYWORD1

LEP_AGC_HISTOGRAM_STATISTICS_T	KEYWORD1
LEP_AGC_HISTOGRAM_STATISTICS_T_PTR	KEYWORD1

LEP_AGC_HEQ_SCALE_FACTOR_E	KEYWORD1
LEP_AGC_HEQ_SCALE_FACTOR_E_PTR	KEYWORD1

LEP_I2C_COMMAND_STATUS_E	KEYWORD1
LEP_I2C_COMMAND_STATUS_E_PTR	KEYWORD1

LEP_OEM_MASK_REVISION_T	KEYWORD1
LEP_OEM_MASK_REVISION_T_PTR	KEYWORD1
LEP_OEM_FFC_NORMALIZATION_TARGET_T	KEYWORD1
LEP_OEM_FFC_NORMALIZATION_TARGET_T_PTR	KEYWORD1
LEP_OEM_FRAME_AVERAGE_T	KEYWORD1
LEP_OEM_FRAME_AVERAGE_T_PTR	KEYWORD1

LEP_OEM_PART_NUMBER_T_TAG
LEP_OEM_PART_NUMBER_T	KEYWORD1
LEP_OEM_PART_NUMBER_T_PTR	KEYWORD1

LEP_OEM_SW_VERSION_T	KEYWORD1
LEP_OEM_SW_VERSION_T_PTR	KEYWORD1

LEP_OEM_VIDEO_OUTPUT_ENABLE_E	KEYWORD1
LEP_OEM_VIDEO_OUTPUT_ENABLE_E_PTR	KEYWORD1

LEP_OEM_VIDEO_OUTPUT_FORMAT_E	KEYWORD1
LEP_OEM_VIDEO_OUTPUT_FORMAT_E_PTR	KEYWORD1

LEP_OEM_VIDEO_OUTPUT_SOURCE_E	KEYWORD1
LEP_OEM_VIDEO_OUTPUT_SOURCE_E_PTR	KEYWORD1

LEP_OEM_VIDEO_OUTPUT_CHANNEL_E	KEYWORD1
LEP_OEM_VIDEO_OUTPUT_CHANNEL_E_PTR	KEYWORD1

LEP_OEM_VIDEO_GAMMA_ENABLE_E	KEYWORD1
LEP_OEM_VIDEO_GAMMA_ENABLE_E_PTR	KEYWORD1

LEP_OEM_MEM_BUFFER_E	KEYWORD1
LEP_OEM_MEM_BUFFER_E_PTR	KEYWORD1

LEP_OEM_STATUS_E	KEYWORD1
LEP_OEM_STATUS_E_PTR	KEYWORD1

LEP_OEM_STATE_E	KEYWORD1
LEP_OEM_STATE_E_PTR	KEYWORD1

LEP_OEM_POWER_STATE_E	KEYWORD1
LEP_OEM_POWER_STATE_E_PTR	KEYWORD1

LEP_OEM_VSYNC_DELAY_E	KEYWORD1
LEP_OEM_VSYNC_DELAY_E_PTR	KEYWORD1

LEP_OEM_GPIO_MODE_E	KEYWORD1
LEP_OEM_GPIO_MODE_E_PTR	KEYWORD1

LEP_OEM_USER_PARAMS_STATE_E	KEYWORD1
LEP_OEM_USER_PARAMS_STATE_E_PTR	KEYWORD1

LEP_OEM_SHUTTER_PROFILE_OBJ_T	KEYWORD1
LEP_OEM_SHUTTER_PROFILE_OBJ_T_PTR	KEYWORD1

LEP_OEM_BAD_PIXEL_REPLACE_CONTROL_T	KEYWORD1
LEP_OEM_BAD_PIXEL_REPLACE_CONTROL_T_PTR	KEYWORD1

LEP_OEM_TEMPORAL_FILTER_CONTROL_T	KEYWORD1
LEP_OEM_TEMPORAL_FILTER_CONTROL_T_PTR	KEYWORD1

LEP_OEM_COLUMN_NOISE_ESTIMATE_CONTROL_T	KEYWORD1
LEP_OEM_COLUMN_NOISE_ESTIMATE_CONTROL_T_PTR	KEYWORD1

LEP_OEM_PIXEL_NOISE_SETTINGS_T	KEYWORD1
LEP_OEM_PIXEL_NOISE_SETTINGS_T_PTR	KEYWORD1

LEP_RAD_RS_T	KEYWORD1
LEP_RAD_RS_T_PTR	KEYWORD1
LEP_RAD_FNUMBER_T	KEYWORD1
LEP_RAD_FNUMBER_T_PTR	KEYWORD1
LEP_RAD_TAULENS_T	KEYWORD1
LEP_RAD_TAULENS_T_PTR	KEYWORD1

LEP_RAD_FNUM_SHUTTER_T	KEYWORD1
LEP_RAD_FNUM_SHUTTER_T_PTR	KEYWORD1
LEP_RAD_RADIOMETRY_FILTER_T	KEYWORD1
LEP_RAD_RADIOMETRY_FILTER_T_PTR	KEYWORD1
LEP_RAD_MEDIAN_VALUE_T	KEYWORD1
LEP_RAD_MEDIAN_VALUE_T_PTR	KEYWORD1
LEP_RAD_PARAMETER_SCALE_FACTOR_T	KEYWORD1
LEP_RAD_PARAMETER_SCALE_FACTOR_T_PTR	KEYWORD1
LEP_RAD_ARBITRARY_OFFSET_T	KEYWORD1
LEP_RAD_ARBITRARY_OFFSET_T_PTR	KEYWORD1
LEP_RAD_SPOTMETER_KELVIN_T	KEYWORD1
LEP_RAD_SPOTMETER_KELVIN_T_PTR	KEYWORD1

LEP_RAD_TEMPERATURE_COUNTS_T	KEYWORD1
LEP_RAD_TEMPERATURE_COUNTS_T_PTR	KEYWORD1

LEP_RAD_KELVIN_T	KEYWORD1
LEP_RAD_KELVIN_T_PTR	KEYWORD1

LEP_RAD_FLUX_T	KEYWORD1
LEP_RAD_FLUX_T_PTR	KEYWORD1

LEP_RAD_GLOBAL_GAIN_T	KEYWORD1
LEP_RAD_GLOBAL_GAIN_T_PTR	KEYWORD1

LEP_RAD_GLOBAL_OFFSET_T	KEYWORD1
LEP_RAD_GLOBAL_OFFSET_T_PTR	KEYWORD1

LEP_RAD_SIGNED_LUT128_T	KEYWORD1
LEP_RAD_SIGNED_LUT128_T_PTR	KEYWORD1
LEP_RAD_LUT128_T	KEYWORD1
LEP_RAD_LUT128_T_PTR	KEYWORD1
LEP_RAD_LUT256_T	KEYWORD1
LEP_RAD_LUT256_T_PTR	KEYWORD1

LEP_RAD_ALPHA_T	KEYWORD1
LEP_RAD_ALPHA_T_PTR	KEYWORD1
LEP_RAD_BETA_T	KEYWORD1
LEP_RAD_BETA_T_PTR	KEYWORD1

LEP_RAD_TS_MODE_E	KEYWORD1
LEP_RAD_TS_MODE_E_PTR	KEYWORD1

LEP_RBFO_T	KEYWORD1
LEP_RBFO_T_PTR	KEYWORD1

LEP_RAD_LINEAR_TEMP_CORRECTION_T	KEYWORD1
LEP_RAD_LINEAR_TEMP_CORRECTION_T_PTR	KEYWORD1

LEP_RAD_ENABLE_E	KEYWORD1
LEP_RAD_ENABLE_E_PTR	KEYWORD1

LEP_RAD_TEMPERATURE_UPDATE_E	KEYWORD1
LEP_RAD_TEMPERATURE_UPDATE_E_PTR	KEYWORD1

LEP_RAD_STATUS_E	KEYWORD1
LEP_RAD_STATUS_E_PTR	KEYWORD1

LEP_RAD_FLUX_LINEAR_PARAMS_T	KEYWORD1
LEP_RAD_FLUX_LINEAR_PARAMS_T_PTR	KEYWORD1

LEP_RAD_TLINEAR_RESOLUTION_E	KEYWORD1
LEP_RAD_TLINEAR_RESOLUTION_E_PTR	KEYWORD1

LEP_RAD_ROI_T	KEYWORD1
LEP_RAD_ROI_T_PTR	KEYWORD1

LEP_RAD_ARBITRARY_OFFSET_MODE_E	KEYWORD1
LEP_RAD_ARBITRARY_OFFSET_MODE_E_PTR	KEYWORD1

LEP_RAD_ARBITRARY_OFFSET_PARAMS_T	KEYWORD1
LEP_RAD_ARBITRARY_OFFSET_PARAMS_T_PTR	KEYWORD1

LEP_RAD_SPOTMETER_OBJ_KELVIN_T	KEYWORD1
LEP_RAD_SPOTMETER_OBJ_KELVIN_T_PTR	KEYWORD1

LEP_RAD_RADIO_CAL_VALUES_T	KEYWORD1
LEP_RAD_RADIO_CAL_VALUES_T_PTR	KEYWORD1


LEP_SYS_FLIR_SERIAL_NUMBER_T	KEYWORD1
LEP_SYS_FLIR_SERIAL_NUMBER_T_PTR	KEYWORD1
LEP_SYS_UPTIME_NUMBER_T	KEYWORD1
LEP_SYS_UPTIME_NUMBER_T_PTR	KEYWORD1
LEP_SYS_AUX_TEMPERATURE_CELCIUS_T	KEYWORD1
LEP_SYS_AUX_TEMPERATURE_CELCIUS_T_PTR	KEYWORD1
LEP_SYS_FPA_TEMPERATURE_CELCIUS_T	KEYWORD1
LEP_SYS_FPA_TEMPERATURE_CELCIUS_T_PTR	KEYWORD1
LEP_SYS_AUX_TEMPERATURE_KELVIN_T	KEYWORD1
LEP_SYS_AUX_TEMPERATURE_KELVIN_T_PTR	KEYWORD1
LEP_SYS_FPA_TEMPERATURE_KELVIN_T	KEYWORD1
LEP_SYS_FPA_TEMPERATURE_KELVIN_T_PTR	KEYWORD1
LEP_SYS_THERMAL_SHUTDOWN_COUNTS_T	KEYWORD1
LEP_SYS_THERMAL_SHUTDOWN_COUNTS_T_PTR	KEYWORD1
LEP_SYS_THRESHOLD_T	KEYWORD1
LEP_SYS_THRESHOLD_T_PTR	KEYWORD1

LEP_SYS_CUST_SERIAL_NUMBER_T	KEYWORD1
LEP_SYS_CUST_SERIAL_NUMBER_T_PTR	KEYWORD1

LEP_SYSTEM_STATUS_STATES_E	KEYWORD1
LEP_SYSTEM_STATUS_STATES_E_PTR	KEYWORD1

LEP_STATUS_T	KEYWORD1
LEP_STATUS_T_PTR	KEYWORD1

LEP_SYS_TELEMETRY_ENABLE_STATE_E	KEYWORD1
LEP_SYS_TELEMETRY_ENABLE_STATE_E_PTR	KEYWORD1

LEP_SYS_TELEMETRY_LOCATION_E	KEYWORD1
LEP_SYS_TELEMETRY_LOCATION_E_PTR	KEYWORD1

LEP_SYS_FRAME_AVERAGE_DIVISOR_E	KEYWORD1
LEP_SYS_FRAME_AVERAGE_DIVISOR_E_PTR	KEYWORD1

LEP_SYS_SCENE_STATISTICS_T	KEYWORD1
LEP_SYS_SCENE_STATISTICS_T_PTR	KEYWORD1

LEP_SYS_BAD_PIXEL_T	KEYWORD1
LEP_SYS_BAD_PIXEL_T_PTR	KEYWORD1

LEP_SYS_VIDEO_ROI_T	KEYWORD1
LEP_SYS_VIDEO_ROI_T_PTR	KEYWORD1

LEP_SYS_ENABLE_E	KEYWORD1
LEP_SYS_ENABLE_E_PTR	KEYWORD1

LEP_SYS_SHUTTER_POSITION_E	KEYWORD1 
LEP_SYS_SHUTTER_POSITION_E_PTR	KEYWORD1

LEP_SYS_FFC_SHUTTER_MODE_E	KEYWORD1
LEP_SYS_FFC_SHUTTER_MODE_E_PTR	KEYWORD1

LEP_SYS_SHUTTER_TEMP_LOCKOUT_STATE_E	KEYWORD1
LEP_SYS_SHUTTER_TEMP_LOCKOUT_STATE_E_PTR	KEYWORD1

LEP_SYS_FFC_SHUTTER_MODE_OBJ_T	KEYWORD1
LEP_SYS_FFC_SHUTTER_MODE_OBJ_T_PTR	KEYWORD1

LEP_SYS_STATUS_E	KEYWORD1
LEP_SYS_STATUS_E_PTR	KEYWORD1

LEP_SYS_GAIN_MODE_E	KEYWORD1
LEP_SYS_GAIN_MODE_E_PTR	KEYWORD1

LEP_SYS_GAIN_MODE_ROI_T	KEYWORD1
LEP_SYS_GAIN_MODE_ROI_T_PTR	KEYWORD1

LEP_SYS_GAIN_MODE_THRESHOLDS_T	KEYWORD1
LEP_SYS_GAIN_MODE_THRESHOLDS_T_PTR	KEYWORD1

LEP_SYS_GAIN_MODE_OBJ_T	KEYWORD1
LEP_SYS_GAIN_MODE_OBJ_T_PTR	KEYWORD1

LEP_SYS_FFC_STATES_E	KEYWORD1
LEP_SYS_FFC_STATES_E_PTR	KEYWORD1

LEP_SYS_BORESIGHT_VALUES_T	KEYWORD1
LEP_SYS_BORESIGHT_VALUES_T_PTR	KEYWORD1

LEP_VID_FOCUS_METRIC_T	KEYWORD1
LEP_VID_FOCUS_METRIC_T_PTR	KEYWORD1
LEP_VID_FOCUS_METRIC_THRESHOLD_T	KEYWORD1
LEP_VID_FOCUS_METRIC_THRESHOLD_T_PTR	KEYWORD1

LEP_POLARITY_E	KEYWORD1
LEP_POLARITY_E_PTR	KEYWORD1

LEP_PCOLOR_LUT_E	KEYWORD1
LEP_PCOLOR_LUT_E_PTR	KEYWORD1

LEP_VID_LUT_PIXEL_T	KEYWORD1
LEP_VID_LUT_PIXEL_T_PTR	KEYWORD1

LEP_VID_LUT_BUFFER_T	KEYWORD1
LEP_VID_LUT_BUFFER_T_PTR	KEYWORD1

LEP_VID_FOCUS_CALC_ENABLE_E	KEYWORD1
LEP_VID_FOCUS_CALC_ENABLE_E_PTR	KEYWORD1

LEP_VID_FOCUS_ROI_T	KEYWORD1
LEP_VID_FOCUS_ROI_T_PTR	KEYWORD1

LEP_VID_SBNUC_ENABLE_E	KEYWORD1
LEP_VID_SBNUC_ENABLE_E_PTR 	KEYWORD1

LEP_VID_FREEZE_ENABLE_E	KEYWORD1
LEP_VID_FREEZE_ENABLE_E_PTR 	KEYWORD1

LEP_VID_BORESIGHT_CALC_ENABLE_STATE_E	KEYWORD1
LEP_VID_BORESIGHT_CALC_ENABLE_STATE_E_PTR	KEYWORD1

LEP_VID_BORESIGHT_COORDINATES_T	KEYWORD1
LEP_VID_BORESIGHT_COORDINATES_T_PTR	KEYWORD1

LEP_VID_TARGET_POSITION_T	KEYWORD1
LEP_VID_TARGET_POSITION_T_PTR	KEYWORD1

LEP_VID_VIDEO_OUTPUT_FORMAT_E	KEYWORD1
LEP_VID_VIDEO_OUTPUT_FORMAT_E_PTR	KEYWORD1

LEP_REG_DIRECTION_E	KEYWORD1

LEP_CMD_PACKET_T	KEYWORD1

CRC16	KEYWORD1


#######################################
# Methods and Functions (KEYWORD2)
#######################################

LEP_SelectDevice	KEYWORD2
LEP_OpenPort	KEYWORD2
LEP_ClosePort	KEYWORD2
LEP_ResetPort	KEYWORD2
LEP_GetPortStatus	KEYWORD2
LEP_GetDeviceAddress	KEYWORD2
LEP_GetAttribute	KEYWORD2
LEP_SetAttribute	KEYWORD2
LEP_RunCommand	KEYWORD2
LEP_DirectWriteBuffer	KEYWORD2
LEP_DirectWriteRegister	KEYWORD2
LEP_DirectReadRegister	KEYWORD2
LEP_GetSDKVersion	KEYWORD2
LEP_GetCameraBootStatus	KEYWORD2
LEP_GetAgcEnableState	KEYWORD2
LEP_SetAgcEnableState	KEYWORD2
LEP_GetAgcPolicy	KEYWORD2
LEP_SetAgcPolicy	KEYWORD2
LEP_GetAgcROI	KEYWORD2
LEP_SetAgcROI	KEYWORD2
LEP_GetAgcLinearHistogramClipPercent	KEYWORD2
LEP_SetAgcLinearHistogramClipPercent	KEYWORD2
LEP_GetAgcHistogramStatistics	KEYWORD2
LEP_GetAgcLinearHistogramTailSize	KEYWORD2
LEP_SetAgcLinearHistogramTailSize	KEYWORD2
LEP_GetAgcHistogramClipPercent	KEYWORD2
LEP_SetAgcHistogramClipPercent	KEYWORD2
LEP_GetAgcLinearMaxGain	KEYWORD2
LEP_SetAgcLinearMaxGain	KEYWORD2
LEP_GetAgcLinearMidPoint	KEYWORD2
LEP_SetAgcLinearMidPoint	KEYWORD2
LEP_GetAgcLinearDampeningFactor	KEYWORD2
LEP_SetAgcLinearDampeningFactor	KEYWORD2
LEP_GetAgcHeqDampingFactor	KEYWORD2
LEP_SetAgcHeqDampingFactor	KEYWORD2
LEP_GetAgcHeqMaxGain	KEYWORD2
LEP_SetAgcHeqMaxGain	KEYWORD2
LEP_GetAgcHeqClipLimitHigh	KEYWORD2
LEP_SetAgcHeqClipLimitHigh	KEYWORD2
LEP_GetAgcHeqClipLimitLow	KEYWORD2
LEP_SetAgcHeqClipLimitLow	KEYWORD2
LEP_GetAgcHeqBinExtension	KEYWORD2
LEP_SetAgcHeqBinExtension	KEYWORD2
LEP_GetAgcHeqMidPoint	KEYWORD2
LEP_SetAgcHeqMidPoint	KEYWORD2
LEP_GetAgcHeqEmptyCount	KEYWORD2
LEP_SetAgcHeqEmptyCount	KEYWORD2
LEP_GetAgcHeqNormalizationFactor	KEYWORD2
LEP_SetAgcHeqNormalizationFactor	KEYWORD2
LEP_GetAgcHeqScaleFactor	KEYWORD2
LEP_SetAgcHeqScaleFactor	KEYWORD2
LEP_GetAgcCalcEnableState	KEYWORD2
LEP_SetAgcCalcEnableState	KEYWORD2
LEP_GetAgcHeqLinearPercent	KEYWORD2
LEP_SetAgcHeqLinearPercent	KEYWORD2
LEP_I2C_GetCommandBusyStatus	KEYWORD2
LEP_I2C_SetCommandRegister	KEYWORD2
LEP_I2C_SelectDevice	KEYWORD2
LEP_I2C_OpenPort	KEYWORD2
LEP_I2C_ClosePort	KEYWORD2
LEP_I2C_ResetPort	KEYWORD2
LEP_I2C_GetAttribute	KEYWORD2
LEP_I2C_SetAttribute	KEYWORD2
LEP_I2C_RunCommand	KEYWORD2
LEP_I2C_ReadData	KEYWORD2
LEP_I2C_WriteData	KEYWORD2
LEP_I2C_GetPortStatus	KEYWORD2
LEP_I2C_GetDeviceAddress	KEYWORD2
LEP_I2C_DirectWriteRegister	KEYWORD2
LEP_I2C_DirectWriteBuffer	KEYWORD2
LEP_I2C_DirectReadRegister	KEYWORD2
LEP_I2C_MasterSelectDevice	KEYWORD2
LEP_I2C_MasterOpen	KEYWORD2
LEP_I2C_MasterClose	KEYWORD2
LEP_I2C_MasterReset	KEYWORD2
LEP_I2C_MasterReadData	KEYWORD2
LEP_I2C_MasterWriteData	KEYWORD2
LEP_I2C_MasterReadRegister	KEYWORD2
LEP_I2C_MasterWriteRegister	KEYWORD2
LEP_I2C_MasterStatus	KEYWORD2
LEP_RunOemPowerDown	KEYWORD2
LEP_RunOemPowerOn	KEYWORD2
LEP_RunOemStandby	KEYWORD2
LEP_RunOemReboot	KEYWORD2
LEP_RunOemLowPowerMode1	KEYWORD2
LEP_RunOemLowPowerMode2	KEYWORD2
LEP_RunOemBit	KEYWORD2
LEP_GetOemMaskRevision	KEYWORD2
LEP_GetOemFlirPartNumber	KEYWORD2
LEP_GetOemCustPartNumber	KEYWORD2
LEP_GetOemSoftwareVersion	KEYWORD2
LEP_GetOemVideoOutputEnable	KEYWORD2
LEP_SetOemVideoOutputEnable	KEYWORD2
LEP_GetOemVideoOutputFormat	KEYWORD2
LEP_SetOemVideoOutputFormat	KEYWORD2
LEP_GetOemVideoOutputSource	KEYWORD2
LEP_SetOemVideoOutputSource	KEYWORD2
LEP_GetOemVideoOutputSourceConstant	KEYWORD2
LEP_SetOemVideoOutputSourceConstant	KEYWORD2
LEP_GetOemVideoOutputChannel	KEYWORD2
LEP_SetOemVideoOutputChannel	KEYWORD2
LEP_GetOemVideoGammaEnable	KEYWORD2
LEP_SetOemVideoGammaEnable	KEYWORD2
LEP_GetOemCalStatus	KEYWORD2
LEP_GetOemFFCNormalizationTarget	KEYWORD2
LEP_SetOemFFCNormalizationTarget	KEYWORD2
LEP_RunOemFFCNormalization	KEYWORD2
LEP_GetOemFrameMean	KEYWORD2
LEP_GetOemPowerMode	KEYWORD2
LEP_SetOemPowerMode	KEYWORD2
LEP_RunOemFFC	KEYWORD2
LEP_GetOemGpioMode	KEYWORD2
LEP_SetOemGpioMode	KEYWORD2
LEP_GetOemGpioVsyncPhaseDelay	KEYWORD2
LEP_SetOemGpioVsyncPhaseDelay	KEYWORD2
LEP_GetOemUserDefaultsState	KEYWORD2
LEP_RunOemUserDefaultsCopyToOtp	KEYWORD2
LEP_RunOemUserDefaultsRestore	KEYWORD2
LEP_GetOemThermalShutdownEnable	KEYWORD2
LEP_SetOemThermalShutdownEnable	KEYWORD2
LEP_GetOemShutterProfileObj	KEYWORD2
LEP_SetOemShutterProfileObj	KEYWORD2
LEP_GetOemBadPixelReplaceControl	KEYWORD2
LEP_SetOemBadPixelReplaceControl	KEYWORD2
LEP_GetOemTemporalFilterControl	KEYWORD2
LEP_SetOemTemporalFilterControl	KEYWORD2
LEP_GetOemColumnNoiseEstimateControl	KEYWORD2
LEP_SetOemColumnNoiseEstimateControl	KEYWORD2
LEP_GetOemPixelNoiseSettings	KEYWORD2
LEP_SetOemPixelNoiseSettings	KEYWORD2
LEP_GetRadTShutterMode	KEYWORD2
LEP_SetRadTShutterMode	KEYWORD2
LEP_GetRadTShutter	KEYWORD2
LEP_SetRadTShutter	KEYWORD2
LEP_RunRadFFC	KEYWORD2
LEP_GetRadRBFOInternal0	KEYWORD2
LEP_SetRadRBFOInternal0	KEYWORD2
LEP_GetRadRBFOExternal0	KEYWORD2
LEP_SetRadRBFOExternal0	KEYWORD2
LEP_GetRadResponsivityShift	KEYWORD2
LEP_SetRadResponsivityShift	KEYWORD2
LEP_GetRadFNumber	KEYWORD2
LEP_SetRadFNumber	KEYWORD2
LEP_GetRadTauLens	KEYWORD2
LEP_SetRadTauLens	KEYWORD2
LEP_GetRadRadometryFilter	KEYWORD2
LEP_SetRadRadometryFilter	KEYWORD2
LEP_GetRadTFpaCLut	KEYWORD2
LEP_SetRadTFpaCLut	KEYWORD2
LEP_GetRadTAuxCLut	KEYWORD2
LEP_SetRadTAuxCLut	KEYWORD2
LEP_GetRadTFpaLut	KEYWORD2
LEP_SetRadTFpaLut	KEYWORD2
LEP_GetRadTAuxLut	KEYWORD2
LEP_SetRadTAuxLut	KEYWORD2
LEP_GetRadResponsivityValueLut	KEYWORD2
LEP_SetRadResponsivityValueLut	KEYWORD2
LEP_GetRadDebugTemp	KEYWORD2
LEP_SetRadDebugTemp	KEYWORD2
LEP_GetRadDebugFlux	KEYWORD2
LEP_SetRadDebugFlux	KEYWORD2
LEP_GetRadEnableState	KEYWORD2
LEP_SetRadEnableState	KEYWORD2
LEP_GetRadGlobalGain	KEYWORD2
LEP_SetRadGlobalGain	KEYWORD2
LEP_GetRadGlobalOffset	KEYWORD2
LEP_SetRadGlobalOffset	KEYWORD2
LEP_GetRadTFpaCtsMode	KEYWORD2
LEP_SetRadTFpaCtsMode	KEYWORD2
LEP_GetRadTAuxCtsMode	KEYWORD2
LEP_SetRadTAuxCtsMode	KEYWORD2
LEP_GetRadTFpaCts	KEYWORD2
LEP_SetRadTFpaCts	KEYWORD2
LEP_GetRadTAuxCts	KEYWORD2
LEP_SetRadTAuxCts	KEYWORD2
LEP_GetRadTEqShutterLut	KEYWORD2
LEP_SetRadTEqShutterLut	KEYWORD2
LEP_GetRadRunStatus	KEYWORD2
LEP_GetRadTEqShutterFlux	KEYWORD2
LEP_SetRadTEqShutterFlux	KEYWORD2
LEP_GetRadMffcFlux	KEYWORD2
LEP_SetRadMffcFlux	KEYWORD2
LEP_GetRadFrameMedianPixelValue	KEYWORD2
LEP_GetRadMLGLut	KEYWORD2
LEP_SetRadMLGLut	KEYWORD2
LEP_GetRadHousingTcp	KEYWORD2
LEP_SetRadHousingTcp	KEYWORD2
LEP_GetRadShutterTcp	KEYWORD2
LEP_SetRadShutterTcp	KEYWORD2
LEP_GetRadLensTcp	KEYWORD2
LEP_SetRadLensTcp	KEYWORD2
LEP_GetRadPreviousGlobalOffset	KEYWORD2
LEP_GetRadPreviousGlobalGain	KEYWORD2
LEP_GetGlobalGainFFC	KEYWORD2
LEP_GetRadCnfScaleFactor	KEYWORD2
LEP_GetRadTnfScaleFactor	KEYWORD2
LEP_GetRadSnfScaleFactor	KEYWORD2
LEP_GetRadArbitraryOffset	KEYWORD2
LEP_SetRadArbitraryOffset	KEYWORD2
LEP_GetRadFluxLinearParams	KEYWORD2
LEP_SetRadFluxLinearParams	KEYWORD2
LEP_GetRadTLinearEnableState	KEYWORD2
LEP_SetRadTLinearEnableState	KEYWORD2
LEP_GetRadTLinearResolution	KEYWORD2
LEP_SetRadTLinearResolution	KEYWORD2
LEP_GetRadTLinearAutoResolution	KEYWORD2
LEP_SetRadTLinearAutoResolution	KEYWORD2
LEP_GetRadSpotmeterRoi	KEYWORD2
LEP_SetRadSpotmeterRoi	KEYWORD2
LEP_GetRadSpotmeterObjInKelvinX100	KEYWORD2
LEP_GetRadArbitraryOffsetMode	KEYWORD2
LEP_SetRadArbitraryOffsetMode	KEYWORD2
LEP_GetRadArbitraryOffsetParams	KEYWORD2
LEP_SetRadArbitraryOffsetParams	KEYWORD2
LEP_GetRadInternalRBFOHighGain	KEYWORD2
LEP_SetRadInternalRBFOHighGain	KEYWORD2
LEP_GetRadExternalRBFOHighGain	KEYWORD2
LEP_SetRadExternalRBFOHighGain	KEYWORD2
LEP_GetRadInternalRBFOLowGain	KEYWORD2
LEP_SetRadInternalRBFOLowGain	KEYWORD2
LEP_GetRadExternalRBFOLowGain	KEYWORD2
LEP_SetRadExternalRBFOLowGain	KEYWORD2
LEP_GetRadRadioCalValues	KEYWORD2
LEP_SetRadRadioCalValues	KEYWORD2
LEP_RunSysPing	KEYWORD2
LEP_GetSysStatus	KEYWORD2
LEP_GetSysFlirSerialNumber	KEYWORD2
LEP_GetSysCustSerialNumber	KEYWORD2
LEP_GetSysCameraUpTime	KEYWORD2
LEP_GetSysAuxTemperatureCelcius	KEYWORD2
LEP_GetSysFpaTemperatureCelcius	KEYWORD2
LEP_GetSysAuxTemperatureKelvin	KEYWORD2
LEP_GetSysFpaTemperatureKelvin	KEYWORD2
LEP_GetSysTelemetryEnableState	KEYWORD2
LEP_SetSysTelemetryEnableState	KEYWORD2
LEP_GetSysTelemetryLocation	KEYWORD2
LEP_SetSysTelemetryLocation	KEYWORD2
LEP_RunSysAverageFrames	KEYWORD2
LEP_GetSysFramesToAverage	KEYWORD2
LEP_SetSysFramesToAverage	KEYWORD2
LEP_GetSysSceneStatistics	KEYWORD2
LEP_RunFrameAverage	KEYWORD2
LEP_GetSysSceneRoi	KEYWORD2
LEP_SetSysSceneRoi	KEYWORD2
LEP_GetSysThermalShutdownCount	KEYWORD2
LEP_GetSysShutterPosition	KEYWORD2
LEP_SetSysShutterPosition	KEYWORD2
LEP_GetSysFfcShutterModeObj	KEYWORD2
LEP_SetSysFfcShutterModeObj	KEYWORD2
LEP_GetSysFFCStatus	KEYWORD2
LEP_RunSysFFCNormalization	KEYWORD2
LEP_GetSysGainMode	KEYWORD2
LEP_SetSysGainMode	KEYWORD2
LEP_GetSysFFCStates	KEYWORD2
LEP_GetSysGainModeObj	KEYWORD2
LEP_SetSysGainModeObj	KEYWORD2
LEP_GetSysBoresightValues	KEYWORD2
LEP_GetVidPolarity	KEYWORD2
LEP_SetVidPolarity	KEYWORD2
LEP_GetVidPcolorLut	KEYWORD2
LEP_SetVidPcolorLut	KEYWORD2
LEP_GetVidLowGainPcolorLut	KEYWORD2
LEP_SetVidLowGainPcolorLut	KEYWORD2
LEP_GetVidUserLut	KEYWORD2
LEP_SetVidUserLut	KEYWORD2
LEP_GetVidFocusCalcEnableState	KEYWORD2
LEP_SetVidFocusCalcEnableState	KEYWORD2
LEP_GetVidBoresightCalcEnableState	KEYWORD2
LEP_SetVidBoresightCalcEnableState	KEYWORD2
LEP_GetVidBoresightCoordinates	KEYWORD2
LEP_GetVidTargetPosition	KEYWORD2
LEP_GetVidROI	KEYWORD2
LEP_SetVidROI	KEYWORD2
LEP_GetVidFocusMetric	KEYWORD2
LEP_GetVidFocusMetricThreshold	KEYWORD2
LEP_SetVidFocusMetricThreshold	KEYWORD2
LEP_GetVidSbNucEnableState	KEYWORD2
LEP_SetVidSbNucEnableState	KEYWORD2
LEP_GetVidFreezeEnableState	KEYWORD2
LEP_SetVidFreezeEnableState	KEYWORD2
LEP_GetVidVideoOutputFormat	KEYWORD2
LEP_SetVidVideoOutputFormat	KEYWORD2
LEP_CalcVidBoresightAlignment	KEYWORD2
DEV_I2C_MasterSelectDevice	KEYWORD2
DEV_I2C_MasterInit	KEYWORD2
DEV_I2C_MasterClose	KEYWORD2
DEV_I2C_MasterReset	KEYWORD2
DEV_I2C_MasterReadData	KEYWORD2
DEV_I2C_MasterWriteData	KEYWORD2
DEV_I2C_MasterReadRegister	KEYWORD2
DEV_I2C_MasterWriteRegister	KEYWORD2
DEV_I2C_MasterStatus	KEYWORD2

#######################################
# Constants (LITERAL1)
#######################################

LEP_FAILURE	LITERAL1
LEP_SUCCESS	LITERAL1
LEP_TRUE 	LITERAL1
LEP_FALSE	LITERAL1
LEP_NULL	LITERAL1

LEP_CID_AGC_ENABLE_STATE	LITERAL1
LEP_CID_AGC_POLICY	LITERAL1
LEP_CID_AGC_ROI	LITERAL1
LEP_CID_AGC_STATISTICS	LITERAL1
LEP_CID_AGC_HISTOGRAM_CLIP_PERCENT	LITERAL1
LEP_CID_AGC_HISTOGRAM_TAIL_SIZE	LITERAL1
LEP_CID_AGC_LINEAR_MAX_GAIN	LITERAL1
LEP_CID_AGC_LINEAR_MIDPOINT	LITERAL1
LEP_CID_AGC_LINEAR_DAMPENING_FACTOR	LITERAL1
LEP_CID_AGC_HEQ_DAMPENING_FACTOR	LITERAL1
LEP_CID_AGC_HEQ_MAX_GAIN	LITERAL1
LEP_CID_AGC_HEQ_CLIP_LIMIT_HIGH	LITERAL1
LEP_CID_AGC_HEQ_CLIP_LIMIT_LOW	LITERAL1
LEP_CID_AGC_HEQ_BIN_EXTENSION	LITERAL1
LEP_CID_AGC_HEQ_MIDPOINT	LITERAL1
LEP_CID_AGC_HEQ_EMPTY_COUNTS	LITERAL1
LEP_CID_AGC_HEQ_NORMALIZATION_FACTOR	LITERAL1
LEP_CID_AGC_HEQ_SCALE_FACTOR	LITERAL1
LEP_CID_AGC_CALC_ENABLE_STATE	LITERAL1
LEP_CID_AGC_HEQ_LINEAR_PERCENT	LITERAL1

LEP_AGC_MAX_HISTOGRAM_CLIP_PERCENT	LITERAL1
LEP_AGC_MAX_HISTOGRAM_TAIL_SIZE	LITERAL1
LEP_AGC_MIN_LINEAR_MAX_GAIN	LITERAL1
LEP_AGC_MAX_LINEAR_MAX_GAIN	LITERAL1
LEP_AGC_MIN_LINEAR_MIDPOINT	LITERAL1
LEP_AGC_MAX_LINEAR_MIDPOINT	LITERAL1
LEP_AGC_MAX_LINEAR_DAMPENING_FACTOR	LITERAL1
LEP_AGC_MAX_HEQ_DAMPENING_FACTOR	LITERAL1
LEP_AGC_MIN_HEQ_MAX_GAIN	LITERAL1
LEP_AGC_MAX_HEQ_MAX_GAIN	LITERAL1

LEP_AGC_HEQ_CLIP_LIMIT_HIGH	LITERAL1
LEP_AGC_HEQ_CLIP_LIMIT_LOW	LITERAL1
LEP_AGC_HEQ_MAX_BIN_EXTENSION	LITERAL1

LEP_AGC_MIN_HEQ_MIDPOINT	LITERAL1
LEP_AGC_MAX_HEQ_MIDPOINT	LITERAL1

LEP_AGC_MAX_COL	LITERAL1
LEP_AGC_MAX_ROW	LITERAL1
LEP_AGC_MIN_COL	LITERAL1
LEP_AGC_MIN_ROW	LITERAL1

LEPTON_I2C_COMMAND_BUSY_WAIT_COUNT	LITERAL1

LEP_I2C_DEVICE_ADDRESS	LITERAL1

LEP_DATA_BUFFER_0_BASE_ADDR	LITERAL1
LEP_DATA_BUFFER_1_BASE_ADDR	LITERAL1

LEP_I2C_REG_BASE_ADDR	LITERAL1

LEP_I2C_POWER_REG	LITERAL1

LEP_I2C_STATUS_REG	LITERAL1
LEP_I2C_COMMAND_REG	LITERAL1
LEP_I2C_DATA_LENGTH_REG	LITERAL1
LEP_I2C_DATA_0_REG	LITERAL1
LEP_I2C_DATA_1_REG	LITERAL1
LEP_I2C_DATA_2_REG	LITERAL1
LEP_I2C_DATA_3_REG	LITERAL1
LEP_I2C_DATA_4_REG	LITERAL1
LEP_I2C_DATA_5_REG	LITERAL1
LEP_I2C_DATA_6_REG	LITERAL1
LEP_I2C_DATA_7_REG	LITERAL1
LEP_I2C_DATA_8_REG	LITERAL1
LEP_I2C_DATA_9_REG	LITERAL1
LEP_I2C_DATA_10_REG	LITERAL1
LEP_I2C_DATA_11_REG	LITERAL1
LEP_I2C_DATA_12_REG	LITERAL1
LEP_I2C_DATA_13_REG	LITERAL1
LEP_I2C_DATA_14_REG	LITERAL1
LEP_I2C_DATA_15_REG	LITERAL1

LEP_I2C_DATA_CRC_REG	LITERAL1

LEP_I2C_DATA_BUFFER_0	LITERAL1
LEP_I2C_DATA_BUFFER_0_END	LITERAL1
LEP_I2C_DATA_BUFFER_0_LENGTH	LITERAL1

LEP_I2C_DATA_BUFFER_1	LITERAL1
LEP_I2C_DATA_BUFFER_1_END	LITERAL1
LEP_I2C_DATA_BUFFER_1_LENGTH	LITERAL1

LEP_I2C_STATUS_BUSY_BIT_MASK	LITERAL1

LEP_CID_OEM_POWER_DOWN	LITERAL1
LEP_CID_OEM_STANDBY	LITERAL1
LEP_CID_OEM_LOW_POWER_MODE_1	LITERAL1
LEP_CID_OEM_LOW_POWER_MODE_2	LITERAL1
LEP_CID_OEM_BIT_TEST	LITERAL1
LEP_CID_OEM_MASK_REVISION	LITERAL1
LEP_CID_OEM_FLIR_PART_NUMBER	LITERAL1
LEP_CID_OEM_SOFTWARE_VERSION	LITERAL1
LEP_CID_OEM_VIDEO_OUTPUT_ENABLE	LITERAL1
LEP_CID_OEM_VIDEO_OUTPUT_FORMAT	LITERAL1
LEP_CID_OEM_VIDEO_OUTPUT_SOURCE	LITERAL1
LEP_CID_OEM_VIDEO_OUTPUT_CHANNEL	LITERAL1
LEP_CID_OEM_VIDEO_GAMMA_ENABLE	LITERAL1
LEP_CID_OEM_CUST_PART_NUMBER	LITERAL1
LEP_CID_OEM_VIDEO_OUTPUT_CONSTANT	LITERAL1
LEP_CID_OEM_REBOOT	LITERAL1
LEP_CID_OEM_FFC_NORMALIZATION_TARGET	LITERAL1
LEP_CID_OEM_STATUS	LITERAL1
LEP_CID_OEM_SCENE_MEAN_VALUE	LITERAL1
LEP_CID_OEM_POWER_MODE	LITERAL1

LEP_CID_OEM_GPIO_MODE_SELECT	LITERAL1
LEP_CID_OEM_GPIO_VSYNC_PHASE_DELAY	LITERAL1

LEP_CID_OEM_USER_DEFAULTS	LITERAL1
LEP_CID_OEM_USER_DEFAULTS_RESTORE	LITERAL1
LEP_CID_OEM_SHUTTER_PROFILE_OBJ	LITERAL1
LEP_CID_OEM_THERMAL_SHUTDOWN_ENABLE_STATE	LITERAL1
LEP_CID_OEM_BAD_PIXEL_REPLACE_CONTROL	LITERAL1
LEP_CID_OEM_TEMPORAL_FILTER_CONTROL	LITERAL1
LEP_CID_OEM_COLUMN_NOISE_ESTIMATE_CONTROL	LITERAL1
LEP_CID_OEM_PIXEL_NOISE_ESTIMATE_CONTROL	LITERAL1

LEP_OEM_MAX_PART_NUMBER_CHAR_SIZE	LITERAL1

LEP_RAD_TEMPERATURE_SCALE_FACTOR	LITERAL1
LEP_RAD_RBFO_SCALE_SHIFT	LITERAL1

LEP_RAD_LUT128_ENTRIES	LITERAL1
LEP_RAD_LUT256_ENTRIES	LITERAL1

LEP_CID_RAD_RBFO_INTERNAL	LITERAL1
LEP_CID_RAD_RBFO_EXTERNAL	LITERAL1
LEP_CID_RAD_DEBUG_TEMP	LITERAL1
LEP_CID_RAD_DEBUG_FLUX	LITERAL1
LEP_CID_RAD_ENABLE_STATE	LITERAL1
LEP_CID_RAD_GLOBAL_OFFSET	LITERAL1
LEP_CID_RAD_TFPA_CTS_MODE	LITERAL1
LEP_CID_RAD_TFPA_CTS	LITERAL1
LEP_CID_RAD_TEQ_SHUTTER_LUT	LITERAL1
LEP_CID_RAD_TSHUTTER_MODE	LITERAL1
LEP_CID_RAD_TSHUTTER	LITERAL1
LEP_CID_RAD_RUN_FFC	LITERAL1
LEP_CID_RAD_RUN_STATUS	LITERAL1
LEP_CID_RAD_RESPONSIVITY_SHIFT	LITERAL1
LEP_CID_RAD_F_NUMBER	LITERAL1
LEP_CID_RAD_TAU_LENS	LITERAL1
LEP_CID_RAD_RESPONSIVITY_VALUE_LUT	LITERAL1
LEP_CID_RAD_GLOBAL_GAIN	LITERAL1
LEP_CID_RAD_RADIOMETRY_FILTER	LITERAL1
LEP_CID_RAD_TFPA_LUT	LITERAL1
LEP_CID_RAD_TAUX_LUT	LITERAL1
LEP_CID_RAD_TAUX_CTS_MODE	LITERAL1
LEP_CID_RAD_TAUX_CTS	LITERAL1
LEP_CID_RAD_TEQ_SHUTTER_FLUX	LITERAL1
LEP_CID_RAD_MFFC_FLUX	LITERAL1
LEP_CID_RAD_FRAME_MEDIAN_VALUE	LITERAL1
LEP_CID_RAD_MLG_LUT	LITERAL1
LEP_CID_RAD_THOUSING_TCP	LITERAL1
LEP_CID_RAD_HOUSING_TCP	LITERAL1
LEP_CID_RAD_SHUTTER_TCP	LITERAL1
LEP_CID_RAD_LENS_TCP	LITERAL1
LEP_CID_RAD_PREVIOUS_GLOBAL_OFFSET	LITERAL1
LEP_CID_RAD_PREVIOUS_GLOBAL_GAIN	LITERAL1
LEP_CID_RAD_GLOBAL_GAIN_FFC	LITERAL1
LEP_CID_RAD_CNF_SCALE_FACTOR	LITERAL1
LEP_CID_RAD_TNF_SCALE_FACTOR	LITERAL1
LEP_CID_RAD_SNF_SCALE_FACTOR	LITERAL1
LEP_CID_RAD_ARBITRARY_OFFSET	LITERAL1

LEP_CID_RAD_FLUX_LINEAR_PARAMS	LITERAL1
LEP_CID_RAD_TLINEAR_ENABLE_STATE	LITERAL1
LEP_CID_RAD_TLINEAR_RESOLUTION	LITERAL1
LEP_CID_RAD_TLINEAR_AUTO_RESOLUTION	LITERAL1
LEP_CID_RAD_SPOTMETER_ROI	LITERAL1
LEP_CID_RAD_SPOTMETER_OBJ_KELVIN	LITERAL1

LEP_CID_RAD_RBFO_INTERNAL_LG	LITERAL1
LEP_CID_RAD_RBFO_EXTERNAL_LG	LITERAL1

LEP_CID_RAD_ARBITRARY_OFFSET_MODE	LITERAL1
LEP_CID_RAD_ARBITRARY_OFFSET_PARAMS	LITERAL1

LEP_CID_RAD_RADIO_CAL_VALUES	LITERAL1

LEP_CID_SYS_PING	LITERAL1
LEP_CID_SYS_CAM_STATUS	LITERAL1
LEP_CID_SYS_FLIR_SERIAL_NUMBER	LITERAL1
LEP_CID_SYS_CAM_UPTIME	LITERAL1
LEP_CID_SYS_AUX_TEMPERATURE_KELVIN	LITERAL1
LEP_CID_SYS_FPA_TEMPERATURE_KELVIN	LITERAL1
LEP_CID_SYS_TELEMETRY_ENABLE_STATE	LITERAL1
LEP_CID_SYS_TELEMETRY_LOCATION	LITERAL1
LEP_CID_SYS_EXECTUE_FRAME_AVERAGE	LITERAL1
LEP_CID_SYS_NUM_FRAMES_TO_AVERAGE	LITERAL1
LEP_CID_SYS_CUST_SERIAL_NUMBER	LITERAL1
LEP_CID_SYS_SCENE_STATISTICS	LITERAL1
LEP_CID_SYS_SCENE_ROI	LITERAL1
LEP_CID_SYS_THERMAL_SHUTDOWN_COUNT	LITERAL1
LEP_CID_SYS_SHUTTER_POSITION	LITERAL1
LEP_CID_SYS_FFC_SHUTTER_MODE_OBJ	LITERAL1
FLR_CID_SYS_RUN_FFC	LITERAL1
LEP_CID_SYS_FFC_STATUS	LITERAL1
LEP_CID_SYS_GAIN_MODE	LITERAL1
LEP_CID_SYS_FFC_STATE	LITERAL1
LEP_CID_SYS_GAIN_MODE_OBJ	LITERAL1
LEP_CID_SYS_GAIN_MODE_DESIRED_FLAG	LITERAL1
LEP_CID_SYS_BORESIGHT_VALUES	LITERAL1

LEP_SYS_MAX_FRAMES_TO_AVERAGE	LITERAL1
LEP_SYS_MAX_SERIAL_NUMBER_CHAR_SIZE	LITERAL1

LEP_CID_VID_POLARITY_SELECT	LITERAL1
LEP_CID_VID_LUT_SELECT	LITERAL1
LEP_CID_VID_LUT_TRANSFER	LITERAL1
LEP_CID_VID_FOCUS_CALC_ENABLE	LITERAL1
LEP_CID_VID_FOCUS_ROI	LITERAL1
LEP_CID_VID_FOCUS_THRESHOLD	LITERAL1
LEP_CID_VID_FOCUS_METRIC	LITERAL1
LEP_CID_VID_SBNUC_ENABLE	LITERAL1
LEP_CID_VID_GAMMA_SELECT	LITERAL1
LEP_CID_VID_FREEZE_ENABLE	LITERAL1
LEP_CID_VID_BORESIGHT_CALC_ENABLE	LITERAL1
LEP_CID_VID_BORESIGHT_COORDINATES	LITERAL1
LEP_CID_VID_VIDEO_OUTPUT_FORMAT	LITERAL1
LEP_CID_VID_LOW_GAIN_COLOR_LUT	LITERAL1

LEPTON_COLOR_LUT_SIZE	LITERAL1

LEP_GET_TYPE	LITERAL1
LEP_SET_TYPE	LITERAL1
LEP_RUN_TYPE	LITERAL1
